100 100
8 17 22 79 25 63 59 70 17 99 85 36 33 99 89 20 22 24 46 59 29 76 74 71 9 28 97 32 12 97 91 25 16 94 49 90 18 1 7 43 30 28 95 92 65 93 85 95 37 5 47 42 77 43 8 32 87 87 57 95 61 35 63 33 45 13 56 30 23 48 63 24 97 65 19 85 26 16 77 42 50 49 56 43 34 68 69 5 17 9 29 9 50 44 66 31 17 60 83 19
87 61 78 68 56 23 50 46 10 66 45 36 38 85 83 3 60 47 90 31 84 43 57 30 55 83 51 29 3 80 9 92 43 29 88 61 36 96 59 27 49 95 11 37 18 14 66 70 46 63 5 70 49 89 94 86 51 0 62 11 39 25 24 57 42 85 54 68 17 2 24 42 47 84 17 43 32 13 75 83 21 92 6 22 58 74 66 15 31 23 72 24 47 12 89 66 50 49 9 62
95 78 24 78 10 88 88 38 48 32 16 28 89 2 37 80 30 23 19 70 44 13 57 30 82 30 4 81 70 67 90 45 89 77 4 98 28 23 32 7 27 11 55 72 61 44 72 79 43 68 57 42 83 66 43 8 30 59 67 91 74 37 37 56 11 57 88 94 6 52 31 31 13 8 7 31 1 47 5 87 3 52 46 18 52 14 67 46 97 71 11 82 84 83 91 49 100 4 86 50
26 39 39 98 89 19 70 51 42 69 38 84 13 40 39 53 94 75 46 49 83 63 87 99 47 45 31 90 25 51 46 74 16 25 30 64 95 30 76 9 36 30 10 68 53 46 92 24 17 43 66 66 5 19 53 82 94 43 5 10 3 23 53 10 12 17 0 10 95 42 27 55 51 31 4 9 66 32 60 14 89 15 100 67 60 39 19 25 55 6 88 60 92 74 93 22 32 99 28 93
100 44 100 11 20 96 34 99 95 3 18 48 9 12 18 98 66 88 81 70 4 82 89 77 78 38 77 26 63 23 90 82 58 93 43 25 72 2 33 59 21 95 57 49 75 48 87 21 0 35 97 100 0 21 87 47 47 11 32 32 55 47 71 45 90 95 45 0 20 98 1 62 96 73 35 41 77 39 67 96 28 29 49 99 93 81 44 80 47 62 93 62 86 54 80 100 35 26 100 80
60 9 74 40 11 42 39 69 67 97 87 35 86 90 23 55 62 25 28 13 78 83 89 79 47 39 53 30 3 56 16 72 9 36 52 51 28 15 98 48 68 34 1 52 68 2 65 100 69 63 28 17 92 78 91 54 73 23 96 92 33 17 15 15 47 11 76 93 82 54 81 39 73 11 69 89 90 30 84 91 29 28 31 75 68 12 28 90 36 59 66 9 6 5 59 98 49 91 29 38
3 35 19 48 9 68 85 90 42 52 34 8 32 46 32 62 22 46 1 34 12 69 62 71 77 94 66 5 50 22 18 90 39 36 5 32 74 90 59 94 71 87 74 48 3 7 75 47 10 3 54 64 63 59 15 14 62 86 96 91 19 44 53 65 14 9 42 15 27 87 22 15 68 91 83 5 44 40 83 5 58 89 8 100 86 54 77 66 82 57 95 18 1 31 89 39 73 7 66 79
66 40 96 95 81 97 65 36 9 100 32 40 17 66 73 16 20 8 4 79 52 23 80 7 33 84 61 78 41 81 52 77 59 25 100 89 96 94 63 67 37 53 17 96 29 52 88 79 100 57 61 53 81 9 66 22 50 12 5 27 86 87 24 81 2 36 33 84 6 94 85 21 12 93 2 7 97 74 51 70 16 C 27 78 63 20 35 5 64 51 73 100 14 62 5 84 21 11 45 82
63 5 6 3 71 100 64 57 4 4 74 78 23 93 57 63 7 11 80 67 32 39 2 67 51 44 40 31 38 92 73 84 15 11 83 44 36 41 0 48 76 22 67 19 55 26 39 33 59 5 25 68 86 54 12 43 82 51 87 98 35 47 28 77 1 3 16 51 96 82 47 12 79 9 100 74 1 67 32 42 4 15 96 33 68 43 7 69 8 7 58 47 69 5 6 46 51 81 84 8
76 42 44 25 77 10 86 95 78 60 63 19 55 57 52 10 42 54 30 60 8 96 39 11 47 24 27 75 70 25 57 64 33 44 36 40 54 71 58 19 13 38 14 47 55 84 84 63 13 73 37 87 19 55 79 87 80 32 98 81 53 92 31 56 39 12 81 32 76 56 71 43 5 56 19 89 91 68 64 79 14 98 66 42 57 56 72 78 47 17 4 66 93 83 5 99 34 57 76 8
91 41 12 24 78 15 62 20 10 58 19 3 0 11 21 56 22 78 36 12 51 73 74 46 5 15 35 17 9 91 99 7 97 30 45 54 35 93 45 14 7 14 98 12 27 33 77 15 48 79 32 65 82 91 0 9 32 76 53 83 41 74 35 34 37 97 47 98 76 76 23 54 28 11 97 47 48 5 69 10 56 61 3 58 73 52 97 11 58 18 58 87 36 97 42 20 21 86 12 94
94 12 98 83 55 39 25 33 80 74 3 93 6 43 85 54 7 95 45 49 55 83 79 57 21 25 34 25 68 60 64 35 10 66 56 71 11 75 29 97 12 31 33 43 26 85 71 54 51 63 54 35 9 46 11 38 52 56 94 79 44 59 79 52 90 64 90 48 58 41 87 31 71 31 55 41 20 6 91 71 92 10 77 52 44 74 80 24 73 55 44 33 72 21 33 51 76 83 42 60
29 69 43 85 76 5 19 83 55 52 64 11 45 17 73 1 90 98 32 29 18 60 47 28 73 48 17 44 65 64 70 23 70 79 9 60 15 74 15 17 3 75 58 1 94 92 13 15 42 50 17 19 75 90 80 95 83 84 16 58 95 37 37 2 93 53 28 87 59 11 31 66 43 32 95 87 12 78 76 10 49 17 87 86 56 15 75 96 86 99 41 89 95 2 26 30 10 93 9 37
100 94 46 55 3 68 98 41 48 30 93 94 19 10 59 93 57 14 79 77 32 59 93 62 80 83 74 57 17 83 89 55 63 38 82 15 51 90 59 52 70 93 3 20 89 67 51 95 82 28 75 99 90 12 38 59 46 82 21 51 49 33 90 28 27 13 59 16 13 63 78 84 76 48 69 97 80 58 84 54 33 86 40 54 94 20 37 20 7 53 42 81 15 52 33 74 4 68 62 34
94 33 1 7 18 77 91 13 16 0 64 76 89 21 63 89 27 44 25 36 80 27 52 60 5 83 78 16 34 82 7 78 76 81 0 3 94 52 44 32 66 25 50 0 98 1 4 60 84 89 29 65 87 85 32 83 76 85 80 17 26 99 85 52 85 96 55 59 52 75 82 38 66 82 76 10 7 25 100 82 11 62 14 49 8 95 42 91 70 12 41 61 54 44 21 80 52 2 53 71
78 67 49 39 58 40 36 47 46 27 76 53 70 29 41 16 72 71 31 28 94 79 4 84 78 90 84 27 62 23 84 80 75 36 50 55 99 11 35 88 48 4 63 70 99 98 76 39 33 20 3 53 38 87 13 65 82 32 48 68 23 17 7 58 97 72 96 74 76 31 8 53 14 39 58 7 77 80 5 70 77 35 90 62 52 3 61 14 31 2 67 88 67 45 6 71 46 49 7 65
24 10 17 71 13 58 51 49 91 25 71 75 86 77 44 1 11 82 99 62 41 91 20 71 7 70 63 83 76 91 21 92 36 17 82 14 35 70 61 55 22 71 85 76 13 66 75 61 5 56 61 48 87 78 54 25 3 40 98 22 82 46 80 39 60 62 0 33 85 96 96 65 98 84 88 46 71 52 98 86 67 21 33 42 90 51 52 39 87 83 90 16 16 48 69 95 87 43 81 98
74 21 99 31 85 27 3 25 83 23 81 26 87 51 40 2 9 0 54 60 12 82 78 0 94 87 25 2 79 94 31 19 76 68 24 22 96 87 36 38 18 62 64 2 14 19 19 55 67 24 98 48 97 95 22 42 97 10 42 57 78 53 13 97 42 21 3 78 47 52 26 52 99 23 9 94 61 68 98 41 0 46 0 62 4 51 56 19 47 90 2 18 83 74 100 76 21 62 63 42
55 25 79 60 98 19 47 6 49 1 41 91 42 64 11 64 98 8 57 74 7 61 27 14 63 54 44 17 31 15 24 97 90 72 28 77 16 56 35 87 43 69 59 98 72 40 67 55 25 77 70 56 80 15 85 24 21 19 27 30 0 56 58 87 48 59 12 49 54 49 2 83 20 82 40 7 86 56 60 20 2 97 100 32 17 36 88 96 11 30 4 11 65 44 12 83 31 70 88 31
32 34 15 55 19 80 20 18 29 38 94 52 14 46 33 48 80 97 99 91 52 63 4 68 99 45 58 8 87 49 92 15 68 73 82 97 38 94 75 92 13 28 32 54 91 14 6 11 8 72 23 24 57 61 5 67 63 30 10 0 40 0 64 81 21 0 12 81 98 17 77 5 23 16 27 82 17 51 81 6 87 100 14 62 52 15 45 77 20 60 55 45 40 98 23 67 12 92 59 53
58 97 17 1 97 73 17 94 12 76 39 46 49 29 14 9 67 66 91 65 26 45 42 51 50 69 33 92 39 9 52 76 1 41 1 67 82 0 18 48 9 57 31 82 11 95 23 3 92 77 3 40 36 77 33 69 47 17 46 62 71 2 86 33 52 65 73 45 85 65 81 26 19 49 31 31 48 26 60 40 14 77 86 43 17 16 70 86 99 0 72 14 0 29 6 33 18 17 99 67
61 50 54 9 99 74 47 71 46 57 77 49 60 99 92 100 39 34 97 31 4 12 88 49 5 69 62 40 83 76 88 87 69 98 21 33 76 63 28 22 71 0 41 19 33 98 32 54 14 38 13 78 65 56 60 80 29 17 19 66 56 65 82 68 26 45 8 61 48 30 68 32 16 78 15 60 79 72 43 64 78 7 50 45 16 95 53 5 71 26 30 23 84 31 44 46 74 98 39 37
87 52 85 92 62 63 76 36 57 22 53 72 15 52 57 53 54 34 100 56 5 78 65 93 73 6 24 1 97 16 4 55 10 53 44 79 14 99 86 79 17 16 3 58 43 72 1 37 76 19 22 67 28 52 19 13 44 9 75 85 6 43 28 82 15 25 8 78 34 71 32 51 9 95 9 15 62 55 8 62 92 82 17 89 15 49 97 20 94 35 43 78 6 97 17 8 64 66 28 44
9 72 72 22 68 48 96 26 38 81 30 88 78 61 11 93 59 63 99 41 86 31 29 4 64 67 19 83 39 83 15 69 22 72 76 49 88 22 38 40 70 61 52 62 66 77 84 67 56 17 89 35 3 59 22 75 63 89 72 88 42 68 75 26 26 40 67 43 19 61 11 58 48 90 55 18 70 59 12 8 79 97 78 15 50 29 14 67 34 5 38 90 28 4 8 9 51 79 58 24
6 61 37 41 57 37 35 79 17 61 77 11 48 54 46 3 20 4 36 89 41 89 21 11 27 73 28 83 30 17 100 7 6 66 88 0 96 59 0 18 54 6 78 65 80 34 80 16 50 47 51 79 38 8 13 74 52 11 76 7 31 48 91 30 35 82 10 74 83 3 98 94 13 73 14 9 76 84 58 58 78 78 1 22 39 27 44 62 59 65 73 43 90 66 93 79 12 22 78 98
94 87 46 90 64 82 34 100 25 91 54 44 94 21 36 89 34 64 96 96 68 62 14 6 89 97 59 63 65 43 35 64 59 10 78 83 6 76 36 47 16 61 92 44 49 97 11 13 64 12 16 67 20 18 4 65 73 88 3 42 59 83 15 19 37 76 77 88 84 6 0 95 81 69 81 46 19 36 32 39 49 29 94 25 72 5 38 0 26 33 90 96 54 22 21 63 56 21 80 17
93 66 92 6 63 14 52 65 95 86 87 92 34 49 26 98 34 58 62 46 37 89 75 79 65 63 70 70 86 37 24 28 11 2 5 76 12 56 60 22 3 100 56 92 27 87 71 24 14 79 100 21 14 71 30 43 17 94 49 80 45 56 98 14 47 76 35 59 44 62 100 92 75 90 60 15 18 83 54 98 92 12 78 5 56 48 78 10 5 83 60 40 40 74 82 5 79 11 68 61
44 3 8 93 82 91 35 61 32 4 6 54 11 12 26 77 31 75 28 45 3 47 24 98 91 41 84 55 57 63 27 62 82 98 78 2 51 81 15 36 20 9 86 13 45 48 98 50 92 75 21 51 5 94 14 6 51 56 98 56 70 92 67 59 72 73 68 61 33 75 67 69 65 5 10 60 71 83 31 46 93 83 66 80 10 82 52 58 79 60 83 32 25 90 81 54 94 49 57 69
29 22 8 54 71 5 40 82 90 18 46 5 11 82 9 43 71 73 20 11 24 53 81 58 66 70 38 72 87 100 77 94 77 90 23 59 54 22 68 22 55 25 90 13 2 12 62 43 98 42 37 68 68 83 59 48 97 4 24 54 58 82 93 66 88 86 10 3 10 43 68 45 50 86 36 38 67 88 29 58 86 24 75 67 46 23 92 8 80 73 33 14 9 57 29 57 6 76 51 73
73 88 85 35 58 77 38 31 54 14 79 11 62 38 19 58 70 30 67 34 76 76 7 53 63 71 6 98 40 55 31 32 88 65 70 53 69 6 0 100 15 53 55 32 28 38 95 47 36 77 9 10 57 72 40 26 17 86 12 91 57 18 97 79 92 3 34 42 1 29 58 35 2 77 3 17 73 74 89 37 56 68 76 42 68 1 96 21 75 63 22 58 76 6 52 8 39 95 82 34
0 84 4 95 64 84 34 66 12 68 33 11 55 37 76 44 60 9 91 43 7 24 31 25 32 69 48 24 65 77 51 27 61 70 2 37 1 61 14 59 82 82 96 37 13 12 83 5 79 18 89 23 66 73 31 92 53 78 57 10 82 78 15 92 5 83 11 8 81 32 86 32 81 32 56 79 98 12 52 14 84 37 99 86 39 89 35 E 59 48 1 11 2 70 83 5 84 22 56 64
46 66 93 24 52 84 35 87 40 39 52 50 21 55 14 63 8 77 1 53 27 97 69 42 6 27 41 17 15 76 4 43 65 64 84 40 3 18 57 65 31 28 14 43 12 97 48 22 26 100 5 6 87 45 27 29 78 10 79 17 95 91 94 90 52 51 80 52 77 68 54 8 52 24 24 51 81 61 89 86 92 51 12 58 23 92 81 36 57 20 88 54 84 12 4 24 5 96 68 89
89 80 36 7 77 11 55 38 19 32 19 15 27 46 77 83 10 68 45 74 13 13 33 50 82 90 91 10 7 34 17 36 33 71 71 6 87 35 28 48 8 66 34 3 51 89 S 96 56 19 33 31 54 43 14 32 95 62 13 39 29 77 72 63 29 97 39 20 92 87 44 75 40 89 93 91 89 60 14 9 36 98 5 55 35 65 47 17 37 61 23 95 25 25 87 20 95 84 16 87
44 81 99 39 67 15 54 66 67 62 12 42 18 35 75 29 79 82 89 32 1 13 63 40 91 86 11 63 88 56 92 74 23 100 73 62 69 21 30 43 14 18 52 22 82 44 60 96 14 68 87 63 77 40 16 90 33 84 11 21 85 26 36 88 11 48 13 35 19 19 50 23 62 55 31 93 6 31 96 64 63 92 25 89 13 47 82 5 95 22 39 42 1 72 91 41 75 91 80 53
14 55 25 46 30 38 66 27 85 71 34 23 54 28 80 35 1 82 57 86 10 50 89 71 48 72 46 67 37 34 45 9 44 26 49 68 51 40 41 48 65 93 89 10 41 34 97 34 97 62 24 80 52 95 23 20 64 0 79 100 14 32 97 31 55 70 17 12 48 28 81 99 79 78 72 99 98 96 23 41 43 6 49 36 8 18 59 63 78 32 17 17 31 30 43 69 96 69 93 16
54 57 81 23 97 61 49 2 75 84 85 93 75 77 79 79 56 90 94 69 74 85 7 38 65 58 58 47 29 69 93 55 32 12 70 85 57 77 79 45 35 3 66 91 93 34 71 46 90 55 59 34 44 84 38 62 95 17 51 62 28 78 83 84 70 43 7 18 38 67 70 18 37 60 52 4 47 45 28 34 2 35 44 35 82 62 56 68 79 90 95 42 14 58 73 54 23 65 7 39
96 7 73 29 66 11 97 82 18 76 54 60 37 30 64 86 68 33 89 73 43 59 88 19 21 85 19 17 84 89 20 64 72 32 1 36 83 11 98 13 70 88 86 75 11 10 47 55 95 6 83 30 67 1 11 27 82 24 7 74 29 100 83 70 4 77 32 97 54 77 68 95 64 62 50 80 17 19 61 94 48 77 70 62 29 67 54 29 53 16 86 61 91 61 58 8 56 74 77 21
71 87 77 98 91 34 0 46 84 13 12 89 98 1 1 98 54 66 45 54 16 100 21 98 88 95 0 78 83 63 1 20 33 81 33 22 84 13 56 98 4 31 61 2 69 29 78 0 51 75 65 28 26 41 64 37 21 40 35 37 48 61 36 85 82 69 100 87 32 55 10 34 38 38 76 100 22 88 51 96 19 80 48 15 31 31 85 86 83 85 81 60 61 90 87 100 69 65 25 77
7 77 69 51 16 72 27 86 6 32 12 49 51 44 48 21 30 90 25 59 73 95 45 24 10 15 11 58 75 43 19 5 82 39 68 91 81 6 47 78 60 20 52 81 73 72 84 77 18 47 11 20 47 41 21 4 1 1 9 34 85 57 2 82 100 85 44 60 21 100 32 74 78 12 60 40 61 19 61 66 6 2 84 4 57 75 91 78 7 49 3 88 14 27 30 69 92 88 33 21
87 12 18 45 39 71 28 88 82 89 66 44 44 85 88 18 99 56 75 92 49 68 62 36 38 21 54 0 70 28 35 79 98 90 86 13 15 90 32 34 87 53 11 8 31 74 11 81 33 93 26 27 78 80 35 81 39 35 29 1 84 42 50 53 76 84 87 50 20 77 19 43 66 6 98 78 46 14 44 13 17 77 73 40 42 28 94 0 68 10 57 30 31 13 13 80 59 56 5 22
94 76 91 28 54 70 89 30 86 27 100 23 15 1 39 55 53 9 38 81 71 95 35 72 41 81 84 3 38 48 77 59 53 35 52 78 27 58 100 88 53 25 44 66 49 28 87 47 16 45 36 41 65 68 33 53 2 5 68 71 72 86 11 72 50 91 81 43 59 44 13 85 69 43 35 73 72 68 84 22 56 22 28 24 96 10 21 95 46 38 92 85 38 94 77 11 29 29 70 2
74 6 6 64 76 80 75 27 83 36 0 3 75 0 30 19 23 38 52 78 60 50 27 86 35 51 97 30 99 97 14 18 74 49 58 84 65 27 72 44 65 98 27 41 47 83 32 77 0 14 3 68 24 33 90 3 85 12 79 22 94 67 23 9 80 77 8 29 100 27 79 64 67 63 34 25 14 44 62 73 59 85 28 4 14 13 8 38 47 29 20 7 52 7 85 89 94 32 97 41
6 96 98 74 27 18 39 17 3 34 23 94 8 64 86 82 5 70 62 70 6 34 55 58 73 1 34 89 96 33 21 53 4 98 59 30 62 39 16 94 44 64 78 76 91 50 85 96 36 11 17 98 41 88 10 21 53 40 24 14 97 20 13 79 50 17 82 99 43 74 78 32 98 16 24 99 7 90 85 24 23 6 93 66 55 88 41 80 15 97 47 0 58 17 63 34 37 12 13 65
86 33 51 3 15 96 86 46 68 40 24 3 84 7 47 84 79 2 58 10 22 78 53 53 18 40 55 78 79 31 17 17 20 14 42 98 7 91 48 12 69 19 3 81 4 70 30 29 70 85 76 73 0 87 23 60 88 91 88 26 24 43 37 62 44 47 68 27 22 66 32 14 77 3 64 37 31 73 95 39 42 83 38 36 78 95 92 75 67 92 24 57 32 81 8 74 46 83 88 84
62 20 92 30 77 72 56 52 96 52 34 52 14 45 52 43 43 10 56 37 95 28 17 23 71 58 89 75 61 84 23 43 B 72 89 42 6 45 53 57 39 95 36 95 12 53 98 65 38 30 84 31 40 76 88 24 69 93 3 58 24 100 83 74 97 14 90 22 73 59 68 80 66 28 47 7 68 74 19 44 5 68 23 98 88 9 100 38 19 6 33 65 77 42 39 96 70 40 1 91
100 27 79 86 41 79 20 86 88 6 74 51 11 93 73 8 31 5 49 23 93 62 62 54 13 31 100 60 32 8 68 45 82 65 19 72 59 52 69 97 74 2 29 22 48 35 42 60 79 8 56 45 30 90 20 30 23 71 49 81 98 67 54 33 74 93 12 4 51 27 47 48 12 80 26 55 94 37 92 8 80 91 32 52 48 5 50 46 58 77 40 57 25 73 71 38 67 100 5 2
43 25 8 14 1 56 70 38 41 25 69 93 63 39 26 63 75 57 52 72 38 46 60 91 17 45 85 11 78 8 28 8 61 7 44 78 55 55 99 80 90 34 94 71 92 28 96 40 71 1 53 27 71 53 39 14 61 22 11 26 95 50 5 90 72 12 67 55 81 50 98 20 74 88 39 52 35 84 43 54 70 14 12 42 60 16 9 12 46 68 43 39 88 55 87 89 97 64 14 25
25 5 10 96 84 34 57 34 19 50 8 54 13 38 49 4 43 76 42 27 73 29 54 84 41 47 86 67 57 45 84 36 3 21 98 95 28 84 82 63 6 24 70 45 79 52 44 19 57 43 77 55 45 13 39 28 86 57 26 71 0 18 48 79 11 72 28 38 68 91 11 45 37 29 83 47 80 39 9 17 9 29 20 29 94 42 29 1 100 58 12 39 95 82 38 65 88 25 33 75
59 47 28 90 58 45 29 83 39 72 49 83 74 96 79 98 2 54 54 97 80 41 26 72 40 94 2 6 73 3 63 98 22 16 2 79 98 50 31 17 61 26 68 19 87 88 66 11 13 46 2 9 80 26 89 14 29 20 26 48 58 21 18 24 72 19 5 67 19 54 51 10 53 82 38 87 56 39 87 6 84 37 92 78 29 18 61 72 20 0 45 37 71 1 29 44 85 10 68 61
90 72 26 64 20 40 95 52 80 56 87 35 23 50 16 29 46 33 39 75 16 72 69 99 70 100 87 84 55 90 25 21 45 37 66 39 38 55 96 52 74 7 98 19 53 81 76 76 17 33 16 32 83 31 73 75 0 22 7 6 4 44 4 48 13 80 82 19 92 100 24 38 78 5 13 34 60 12 67 2 27 31 23 53 42 2 45 22 87 33 39 35 85 87 21 12 17 91 59 90
73 96 57 41 48 58 74 66 76 34 17 100 5 100 85 47 49 83 62 83 98 41 85 96 39 10 12 66 84 83 34 67 84 60 57 66 63 90 12 58 100 7 95 80 63 24 27 26 80 30 95 75 47 38 36 57 51 1 62 27 3 31 52 12 36 33 19 13 35 66 9 44 96 28 77 79 90 35 13 54 40 87 81 39 2 66 3 66 30 98 3 67 91 75 2 54 3 92 99 92
69 35 38 36 6 65 18 61 66 95 69 2 87 52 6 50 48 89 32 65 91 99 79 47 20 27 29 24 96 18 61 79 79 61 57 74 76 84 63 7 96 66 26 18 43 71 87 2 65 2 43 8 8 73 54 2 8 42 9 22 12 82 84 78 97 31 74 70 39 1 45 61 66 27 2 11 34 16 28 9 99 20 73 57 77 86 66 18 42 67 42 13 48 16 93 93 89 75 14 58
44 24 93 65 37 22 35 91 100 24 78 50 88 58 43 28 70 48 81 8 98 89 83 42 75 6 78 95 79 62 94 75 28 18 81 25 18 69 32 85 93 57 95 39 90 6 20 11 87 20 61 11 36 29 92 66 71 81 35 80 26 70 59 6 94 34 59 66 16 42 36 2 28 97 8 33 93 75 37 51 75 38 35 55 67 37 59 47 7 35 62 84 5 20 83 34 19 86 60 25
16 89 77 70 28 5 45 63 87 70 93 49 67 87 78 14 58 46 62 56 62 19 68 99 68 50 21 64 89 18 48 85 43 19 45 55 1 3 75 49 59 76 9 4 43 80 51 54 86 28 48 79 46 2 16 92 58 16 82 65 1 32 64 11 73 44 26 62 54 16 20 4 74 6 83 41 32 13 29 88 14 55 35 32 50 41 24 35 24 8 19 99 90 39 95 11 64 8 59 14
13 72 69 34 51 74 51 29 43 55 19 52 78 82 59 45 30 20 88 54 20 40 94 90 37 5 99 55 45 84 57 13 71 22 87 42 95 11 63 1 21 14 21 67 96 0 66 97 20 63 69 50 72 44 76 59 51 93 53 2 46 86 51 45 54 41 6 67 17 48 28 47 93 69 53 32 13 5 28 50 30 93 29 97 58 76 27 99 8 71 36 34 97 92 13 6 73 38 13 57
67 88 49 8 35 87 30 32 46 29 15 96 97 1 65 66 56 48 55 43 88 91 27 23 57 8 51 52 33 8 29 56 82 60 51 46 13 53 40 21 80 56 78 46 14 8 20 0 23 38 84 83 74 38 31 82 50 64 39 57 33 77 60 26 36 68 1 93 29 58 26 70 4 4 82 98 1 62 57 75 60 56 66 53 41 21 16 83 84 22 59 79 29 23 34 41 93 50 81 19
20 47 51 79 31 33 3 43 92 9 15 64 88 58 69 65 20 40 87 43 20 87 91 7 79 23 8 42 16 36 92 6 36 23 98 70 66 66 81 35 61 18 51 29 32 71 27 16 25 30 18 36 17 80 67 81 89 29 55 33 53 74 62 5 49 59 23 6 37 96 43 78 10 34 66 79 62 30 55 6 62 16 63 18 51 3 69 64 97 70 57 81 99 15 99 58 16 48 43 100
33 15 66 60 35 92 1 43 75 15 81 51 42 39 16 37 74 14 42 31 94 100 55 87 76 78 20 67 69 53 18 29 63 75 81 82 42 6 62 50 97 42 25 52 64 80 86 71 46 18 30 50 83 52 88 41 44 57 26 2 86 75 89 2 79 2 100 76 72 11 7 16 82 97 62 71 5 41 17 40 65 58 16 0 82 26 12 37 19 16 71 42 59 51 3 59 14 25 99 22
30 73 76 17 38 27 24 65 52 94 91 7 0 86 10 8 30 56 34 82 36 76 46 50 38 87 76 22 23 73 10 71 8 100 48 40 75 59 80 64 66 48 78 46 85 80 54 34 44 90 46 69 81 29 49 66 78 57 69 75 0 64 96 92 35 95 58 74 1 76 2 78 79 51 13 27 84 81 66 28 75 21 69 3 30 47 7 30 24 83 86 55 14 8 17 75 99 93 80 66
60 57 14 68 44 66 99 24 86 51 82 50 95 81 46 94 62 3 4 15 13 10 14 48 70 98 59 22 86 91 88 69 94 31 96 38 17 4 38 38 69 65 40 7 1 5 40 45 2 23 23 64 82 75 79 4 22 6 16 50 0 83 37 92 98 63 89 33 99 3 4 46 99 52 75 19 85 63 84 68 17 93 12 75 37 18 91 54 62 46 69 26 2 82 63 35 42 94 75 69
70 38 65 95 34 87 70 1 24 45 3 13 86 0 40 93 70 65 64 7 8 61 13 99 13 59 93 48 88 89 25 21 62 6 32 88 15 51 89 22 0 71 54 88 67 51 39 16 69 95 28 86 91 97 100 14 87 59 99 52 82 92 84 67 96 58 12 53 30 19 66 77 69 7 86 53 19 55 43 18 29 82 96 40 7 77 32 89 70 15 68 29 74 6 96 65 3 73 57 94
75 77 93 33 41 27 52 55 72 71 2 75 85 69 32 79 79 88 96 4 46 43 30 51 37 27 77 72 63 76 52 44 65 76 14 40 62 76 49 60 7 47 54 4 25 26 66 76 44 16 48 81 46 36 31 42 1 20 78 65 74 63 20 44 67 48 29 33 53 5 88 53 79 48 17 76 85 35 69 13 4 52 32 42 83 52 21 44 64 0 12 3 38 38 92 61 54 83 67 23
27 64 66 63 46 100 81 53 69 20 63 40 49 81 60 88 45 4 31 60 31 39 28 8 78 73 28 58 65 50 50 98 33 10 58 32 29 61 63 40 40 89 29 20 35 30 6 47 71 70 56 98 92 71 35 76 83 69 95 5 95 35 48 28 25 46 88 7 22 36 14 94 31 71 9 34 37 97 19 85 58 33 10 16 75 33 80 19 46 52 61 13 8 78 84 22 70 21 58 78
85 45 21 73 96 54 75 91 12 51 56 12 84 63 70 74 64 17 17 6 54 21 76 55 79 59 5 8 31 21 0 11 93 26 97 4 34 90 64 29 34 42 94 42 33 35 75 9 68 85 78 43 52 63 0 45 88 40 94 76 31 80 55 100 20 21 77 83 72 90 42 99 54 77 19 50 31 20 58 46 76 69 91 84 42 47 9 43 18 11 66 43 6 100 75 15 93 57 11 60
74 8 54 73 89 3 94 30 86 66 58 30 60 55 16 38 71 69 63 98 84 58 16 64 19 63 59 59 40 3 39 33 6 58 89 73 32 17 11 93 29 47 34 90 73 84 61 7 24 83 4 80 3 21 18 75 4 26 39 73 43 63 7 55 36 67 98 28 72 52 12 81 4 10 56 28 82 8 27 18 50 47 78 72 93 69 100 19 93 63 76 1 76 61 15 73 59 89 89 86
39 100 70 52 70 46 37 34 90 96 84 86 65 38 25 46 9 44 0 97 13 8 65 46 14 49 81 77 22 83 65 88 45 71 86 4 26 99 77 49 57 63 46 88 56 82 1 31 73 15 8 27 75 36 60 4 89 71 95 88 56 45 32 82 45 40 40 80 78 31 88 72 3 4 83 68 20 36 66 2 73 57 9 40 94 100 12 87 56 72 23 77 91 22 6 19 64 94 83 69
65 94 97 95 69 71 16 4 79 64 100 43 86 63 30 16 58 72 77 81 40 87 85 21 98 31 44 40 36 84 5 59 60 45 48 86 84 27 97 37 56 94 83 13 80 58 93 91 81 50 56 93 64 31 38 64 27 100 99 13 9 98 87 98 10 70 73 56 60 75 83 26 10 1 54 98 50 77 64 36 4 68 7 24 85 76 67 25 41 50 7 13 64 49 75 26 19 34 5 73
22 41 50 51 88 44 7 16 92 20 71 73 31 24 43 35 7 95 20 25 86 88 75 52 83 31 9 17 12 51 21 48 50 20 18 9 59 13 87 75 62 72 65 39 13 99 24 58 4 23 14 28 36 12 70 52 20 54 49 15 40 93 41 26 86 86 90 44 1 81 8 43 69 8 99 42 47 82 25 82 32 41 65 54 9 74 40 6 55 38 39 63 86 26 8 39 52 43 59 45
91 26 28 98 58 27 88 49 10 93 19 77 25 97 72 77 1 93 19 39 51 57 9 65 9 12 76 10 44 50 93 92 91 7 23 54 65 14 94 58 59 54 2 37 90 65 73 87 13 91 68 29 53 18 60 26 86 4 64 62 2 18 66 97 87 60 81 41 37 62 54 8 32 70 10 53 8 93 59 99 45 92 50 61 63 53 13 80 1 36 82 6 94 1 21 99 14 20 62 61
33 60 11 7 86 29 49 41 63 77 90 11 96 73 49 100 1 68 73 58 85 69 79 51 89 87 51 10 81 6 77 73 42 17 39 69 92 28 73 45 18 55 28 29 32 75 65 41 24 25 47 13 61 7 7 92 10 78 58 87 11 51 89 51 29 99 18 43 41 52 87 74 2 11 77 61 74 39 27 56 83 51 93 9 22 3 5 5 77 72 55 10 56 11 45 23 31 2 24 43
57 35 97 82 75 2 38 100 51 99 66 54 37 62 80 34 91 9 60 48 46 27 80 64 11 76 13 64 72 14 17 1 38 53 12 79 58 40 69 18 48 99 78 98 23 38 80 47 77 53 79 20 25 3 62 27 3 35 86 71 97 31 51 31 95 3 49 36 61 88 91 62 77 19 1 35 91 46 84 100 70 66 64 77 78 81 18 81 34 32 3 63 84 65 4 10 14 32 100 76
0 88 94 77 5 89 4 29 5 15 7 37 86 53 8 32 67 3 72 48 80 91 62 21 34 24 22 8 25 40 79 7 68 16 97 8 16 97 85 83 56 11 14 43 45 29 26 24 1 77 70 32 90 89 29 21 74 21 59 93 62 33 87 53 26 19 62 50 88 81 82 1 80 45 56 64 69 1 1 48 45 38 11 34 98 2 36 54 53 70 12 82 51 12 87 73 28 8 61 13
28 49 67 15 13 24 79 89 36 21 10 72 66 86 60 79 4 53 29 77 88 90 53 75 65 86 26 36 95 71 96 61 43 84 69 56 16 35 27 71 49 61 77 76 90 75 67 91 13 77 42 44 84 81 46 16 80 77 53 26 25 37 14 40 15 43 30 41 59 69 33 49 54 46 89 54 48 75 14 4 88 22 75 74 26 84 14 72 65 82 55 10 75 66 93 65 53 98 27 29
18 96 9 39 34 6 15 33 78 95 91 14 54 61 11 59 59 20 76 46 25 72 70 3 41 13 68 11 30 32 89 20 27 89 44 95 3 85 41 92 13 0 27 40 30 18 26 80 28 65 55 63 75 97 73 5 50 85 5 92 3 39 43 16 66 68 100 92 33 70 48 10 57 77 14 23 23 48 33 36 63 85 86 64 94 68 65 68 73 0 53 17 85 28 15 15 58 9 38 14
73 74 60 3 11 58 16 5 75 46 44 74 89 25 28 85 21 66 2 28 27 85 95 81 77 89 5 40 35 74 85 50 80 54 80 22 98 93 84 77 74 75 85 20 39 10 41 17 24 14 51 97 40 22 64 39 66 16 61 58 82 71 2 64 63 34 37 49 65 45 76 83 29 29 51 13 68 7 43 60 9 0 59 99 65 99 83 45 59 58 38 60 3 71 70 6 71 77 11 10
38 49 70 91 34 6 73 13 36 96 74 1 17 88 32 95 75 45 84 57 56 74 77 73 28 14 4 87 72 85 65 73 17 5 92 75 13 96 72 16 44 46 12 32 67 13 68 92 98 36 54 87 96 39 42 99 66 50 80 98 91 56 67 17 65 27 39 34 3 72 20 63 72 83 38 37 64 75 7 16 14 75 90 58 71 39 68 50 39 100 84 17 32 98 30 8 65 41 100 44
30 9 80 77 4 36 61 82 61 1 7 35 23 84 28 31 30 8 93 96 67 71 70 42 90 61 22 35 25 18 68 30 76 66 63 89 67 12 17 66 12 48 63 94 2 91 17 25 100 27 19 94 84 84 70 65 61 90 22 48 12 42 79 33 98 21 87 81 38 8 33 35 93 18 29 64 49 59 16 88 74 5 69 100 86 99 50 48 70 14 17 2 75 53 39 30 46 4 4 47
17 52 10 75 52 96 53 9 94 24 5 52 36 74 78 21 12 75 56 79 18 4 65 59 84 12 83 80 100 29 61 9 16 82 88 22 55 41 97 39 25 49 40 65 71 23 56 61 43 4 73 10 64 8 9 32 27 18 10 36 95 53 24 5 27 8 32 92 48 46 53 77 20 51 32 88 16 17 46 73 33 74 57 64 66 95 100 51 84 41 89 9 96 55 98 93 90 82 88 49
30 53 13 5 77 43 20 83 88 67 68 14 84 22 84 81 8 88 22 52 100 59 77 18 10 37 100 24 16 80 84 49 54 91 42 20 7 90 48 33 49 2 48 44 65 45 81 83 24 6 78 44 30 35 16 68 52 37 59 17 38 57 11 84 7 0 26 32 28 12 18 54 37 82 90 90 82 97 83 68 62 98 55 24 65 71 54 45 2 88 41 27 74 1 73 73 59 36 4 20
28 42 90 29 51 26 46 29 68 69 14 7 58 85 27 55 53 65 62 13 78 23 44 17 77 49 58 32 62 48 46 62 69 34 42 74 98 96 4 1 65 93 73 28 63 43 56 85 47 66 15 35 84 88 32 8 47 38 67 59 42 60 55 35 39 73 98 64 65 72 94 27 0 67 65 93 95 59 9 75 56 94 88 79 1 16 95 84 68 86 80 5 8 26 49 95 24 9 11 100
28 1 38 14 74 85 44 15 60 2 28 40 83 54 80 24 88 24 76 60 97 53 62 48 63 0 8 46 17 26 58 74 81 46 41 69 94 27 35 20 28 45 11 83 21 79 27 46 17 12 73 20 39 17 66 23 95 25 6 41 84 21 95 88 84 20 62 43 5 91 3 67 23 73 62 100 32 27 15 72 52 47 22 15 19 38 57 89 45 74 37 30 87 8 1 87 61 47 25 56
61 73 13 15 71 75 48 22 29 90 93 1 92 87 3 67 55 86 12 41 39 36 1 12 13 36 29 77 4 61 93 82 86 23 20 67 47 42 70 92 23 76 8 50 54 48 43 60 3 20 43 33 38 92 13 64 65 39 50 70 86 59 61 40 90 65 59 66 50 44 71 96 47 63 63 17 30 13 77 42 27 65 2 69 1 71 48 23 69 16 91 33 98 94 17 37 38 93 0 B
17 41 4 48 74 85 65 89 15 46 65 27 20 97 48 12 59 47 1 2 39 42 25 16 98 37 35 38 5 1 25 69 58 97 88 84 63 85 64 55 50 63 52 59 67 54 40 65 34 51 98 15 26 36 6 62 59 37 41 70 52 38 23 48 83 25 59 50 47 30 24 86 93 55 82 84 54 65 85 87 55 44 23 72 81 63 18 94 14 84 4 19 40 96 74 32 15 23 9 68
41 41 7 73 10 39 38 51 98 92 34 14 94 28 82 70 68 28 40 71 88 22 46 18 80 7 41 28 74 16 10 84 4 88 85 67 100 37 94 82 97 3 5 26 28 70 95 13 70 34 58 87 30 50 45 89 66 23 16 94 42 98 11 2 97 33 71 65 67 21 2 97 30 6 17 85 57 45 72 57 79 57 61 60 46 31 81 12 5 63 34 91 80 44 89 1 55 17 43 39
40 81 64 33 26 59 72 22 63 25 12 62 5 33 55 36 86 89 67 51 44 27 28 2 89 10 97 4 50 69 9 10 71 93 26 56 91 37 11 55 64 92 75 0 41 94 76 7 11 39 85 43 2 27 95 2 36 97 100 27 57 20 19 62 99 20 23 3 22 69 88 93 78 10 24 62 41 19 21 59 65 87 65 28 78 31 49 53 78 67 98 100 81 23 100 9 7 41 67 57
93 82 41 81 86 21 27 5 84 26 66 69 56 79 39 84 43 91 57 35 40 3 38 21 21 34 7 63 7 40 18 76 11 42 21 41 97 79 68 83 93 85 24 19 87 79 9 9 83 59 80 15 51 18 89 9 66 75 22 73 38 85 44 80 33 52 72 37 83 49 0 66 65 92 73 85 91 81 21 47 5 81 70 57 14 20 79 4 53 80 73 57 66 35 48 39 39 13 13 55
100 40 32 51 16 92 56 68 31 51 70 84 0 54 5 41 58 28 28 14 21 84 92 9 82 40 65 15 55 2 29 75 60 77 12 10 75 6 71 58 48 59 41 89 44 98 84 7 64 5 51 9 53 4 78 39 48 89 72 4 36 69 66 41 58 61 31 20 6 31 47 24 42 94 83 67 49 67 42 65 24 63 47 81 9 15 88 36 33 68 91 42 23 81 12 89 86 47 14 89
44 2 53 24 62 42 5 2 84 33 36 50 25 48 3 7 23 47 71 42 69 40 96 71 93 16 23 22 18 3 67 35 53 26 21 19 97 64 33 19 41 52 74 87 76 91 62 70 69 99 33 42 7 62 17 3 93 67 22 69 16 44 82 91 18 54 24 5 44 40 94 83 75 95 40 18 63 98 7 12 82 23 97 44 65 96 49 59 98 48 14 18 25 5 37 70 34 52 71 56
66 23 100 82 34 43 68 99 54 63 67 1 6 32 82 60 35 24 B 40 58 95 27 99 6 90 8 15 57 33 42 87 52 2 45 58 34 27 0 9 1 55 16 43 74 15 59 33 41 15 56 0 63 17 22 47 49 16 9 6 60 52 73 18 49 68 82 27 78 74 60 25 26 69 80 11 70 27 97 33 73 0 67 96 26 20 49 73 49 84 96 88 66 38 0 47 79 93 1 53
85 72 61 53 25 40 70 38 73 84 89 83 44 32 7 18 14 26 27 49 18 100 72 19 95 73 28 87 1 30 82 73 98 8 56 0 34 92 71 46 3 45 70 0 87 65 53 80 40 52 26 19 31 79 85 36 18 85 49 95 47 50 11 52 58 34 90 77 92 71 8 42 92 75 21 21 15 18 18 97 31 62 23 82 27 96 6 13 82 92 51 86 13 59 71 62 21 16 70 82
42 18 31 52 71 9 88 21 14 32 35 18 28 74 29 82 33 91 17 61 26 35 18 61 37 12 0 28 0 53 86 58 4 99 9 20 16 14 88 18 90 91 65 23 61 17 67 27 40 61 84 22 93 65 24 92 97 78 83 17 89 33 70 76 8 45 35 9 24 62 21 29 28 41 60 100 5 49 99 55 67 14 78 11 41 97 34 85 66 26 44 18 81 82 32 32 67 9 19 97
31 67 88 90 24 17 94 39 41 72 3 15 31 47 100 9 51 100 49 1 17 46 49 10 100 38 75 81 16 12 36 40 40 44 68 70 52 32 18 43 63 72 6 71 87 99 95 63 68 5 12 5 95 43 89 38 33 43 54 33 38 15 66 14 60 34 51 71 74 48 48 92 58 49 10 32 29 39 58 13 70 97 53 53 87 27 22 30 94 8 16 28 38 64 61 31 77 71 45 29
25 90 32 99 21 20 15 49 9 7 30 99 21 58 56 47 78 16 23 63 69 93 25 100 72 18 21 51 45 32 94 16 96 13 83 48 49 62 57 24 11 56 86 35 59 79 5 61 3 54 71 8 4 10 81 80 75 69 49 75 28 50 89 63 19 93 73 48 91 79 37 7 26 20 68 50 68 85 69 91 54 22 52 98 81 86 8 32 31 38 58 65 52 86 16 93 75 97 88 86
68 61 71 17 86 23 95 73 32 11 47 33 34 0 11 12 2 35 86 77 19 71 72 79 9 59 11 35 5 12 100 51 92 36 85 37 36 63 63 53 11 35 52 72 36 40 26 58 44 23 74 79 35 6 58 34 80 73 25 91 41 26 49 54 28 43 73 13 7 13 40 81 58 77 84 67 72 55 23 19 58 87 47 53 46 55 82 39 79 100 23 62 70 78 58 89 94 63 19 55
83 98 12 92 51 5 79 96 46 58 95 85 65 21 86 71 36 61 7 6 22 55 65 89 25 14 35 95 22 49 35 95 83 11 96 3 24 59 23 32 95 63 49 10 81 75 12 28 54 39 80 43 78 48 40 7 18 6 23 98 86 83 70 39 71 69 91 44 64 6 5 84 100 5 38 99 0 67 32 8 83 7 46 43 12 61 96 54 43 50 41 16 4 100 87 1 82 28 93 46
47 42 40 0 99 29 56 15 5 99 90 0 61 78 13 67 54 61 94 60 16 41 63 94 74 76 63 84 8 18 0 26 57 68 25 10 50 50 88 43 63 50 92 100 15 50 91 52 97 88 21 51 83 90 11 80 29 31 50 99 5 92 73 95 47 45 49 88 7 64 99 1 92 100 5 70 84 7 56 71 75 44 33 59 24 53 97 57 48 48 71 35 73 61 36 13 36 6 51 39
6 52 47 21 33 22 35 98 7 93 2 34 66 2 95 95 60 23 24 74 42 71 5 60 49 45 9 2 55 19 28 78 4 82 33 92 15 3 66 33 91 17 94 3 18 40 75 53 61 75 32 92 13 28 75 3 19 56 86 71 41 34 40 74 11 54 37 61 30 76 69 7 69 67 22 39 6 11 50 73 57 71 75 78 100 86 20 28 18 24 41 98 49 11 37 56 100 93 47 39
34 18 96 48 53 24 30 75 57 90 52 29 62 1 53 15 63 77 95 100 20 55 1 22 58 79 43 85 13 21 34 6 43 55 25 25 70 51 8 66 63 34 74 42 67 93 26 95 88 43 37 11 96 38 79 100 45 2 42 43 63 86 31 25 21 52 4 12 7 47 0 77 49 14 48 91 4 15 30 35 34 65 76 8 100 19 69 13 8 48 0 69 98 76 83 76 89 33 3 11
7 2 33 9 59 75 17 7 61 59 58 8 28 17 30 33 19 90 76 49 10 66 73 44 35 84 26 9 6 58 88 49 24 40 40 5 67 39 6 55 92 70 63 9 58 29 46 21 7 61 64 12 94 46 16 44 38 54 14 76 46 23 14 48 83 26 11 56 77 38 87 35 27 64 66 79 7 58 56 59 80 60 81 1 52 51 69 40 30 76 24 63 42 23 37 52 13 81 92 27
9 13 66 7 21 34 4 6 58 55 0 16 83 97 44 42 45 99 29 23 84 100 24 27 96 50 58 41 89 64 83 34 55 88 26 74 13 24 53 35 8 31 38 58 11 6 79 15 87 67 9 85 29 57 70 23 50 91 80 82 71 64 4 43 74 55 33 98 42 33 20 46 90 3 85 4 1 3 70 86 94 99 51 17 79 41 75 86 15 79 88 19 11 54 67 61 51 7 83 25
