100 100
20 78 21 35 64 12 95 50 60 68 61 66 78 81 82 66 84 20 90 58 37 55 23 90 84 59 91 26 14 32 99 55 38 31 20 35 75 29 58 46 24 89 88 32 45 64 76 22 42 95 97 65 56 92 65 13 86 46 19 26 88 31 69 97 44 32 14 16 49 13 9 97 31 55 63 55 86 45 0 51 50 42 71 71 12 90 47 71 41 41 88 20 63 75 55 55 99 77 40 97
83 4 7 3 3 67 97 0 63 89 38 76 34 35 34 97 35 34 29 16 100 2 92 97 18 8 44 47 72 9 38 30 79 28 32 43 89 100 8 51 52 93 72 2 49 90 18 44 39 6 2 92 33 34 23 73 68 75 97 7 83 24 9 32 63 92 23 29 97 80 20 91 68 27 90 73 48 25 68 63 45 26 11 57 92 38 34 71 88 11 33 45 68 84 54 98 75 79 79 94
93 4 70 12 77 54 6 66 92 19 72 24 63 49 29 6 9 66 6 10 33 51 67 67 35 46 1 30 23 84 91 63 53 9 0 24 88 7 80 48 14 41 91 20 96 94 49 13 83 15 21 89 24 18 17 22 60 71 41 94 19 43 95 11 9 70 2 95 52 12 18 76 82 11 20 47 76 28 1 17 99 54 28 87 78 62 6 17 40 14 84 73 11 39 89 55 52 35 4 14
31 34 99 28 34 88 2 17 46 17 97 78 41 37 74 12 79 88 12 94 57 3 100 87 93 46 76 54 36 15 7 17 56 7 97 23 41 75 84 44 97 37 67 23 64 89 18 41 62 16 31 11 32 90 81 10 86 64 58 94 19 59 90 36 15 79 90 35 6 85 29 83 91 25 59 48 44 63 25 11 97 66 28 67 40 35 19 82 44 8 10 69 9 89 55 70 37 82 81 7
99 45 54 79 40 23 13 27 28 50 9 29 93 66 70 88 39 64 78 13 36 74 5 0 30 41 68 60 52 5 65 97 76 67 70 37 5 44 82 85 92 67 15 15 83 22 23 0 4 57 23 26 4 10 77 15 6 94 74 12 71 56 77 15 69 96 91 97 92 39 53 74 7 84 4 6 86 61 54 81 67 43 60 68 92 43 30 8 17 94 53 3 72 47 65 11 59 78 45 95
83 83 13 60 92 31 2 16 0 66 64 47 6 66 82 53 17 43 83 98 32 27 64 47 90 55 63 80 11 90 0 18 21 56 4 45 60 32 26 97 99 74 68 2 28 20 22 19 95 28 78 90 57 50 97 94 29 89 92 21 53 31 30 95 57 65 14 20 71 45 32 83 69 6 73 99 12 9 8 28 21 8 40 23 66 17 21 11 71 18 46 36 31 50 73 30 14 77 75 71
66 84 72 1 30 77 7 89 100 47 92 11 25 95 78 59 75 32 88 53 34 24 84 58 69 30 38 78 81 53 0 45 100 31 58 71 64 18 5 28 9 25 55 94 89 11 74 19 48 59 55 49 30 66 35 92 12 50 70 22 37 44 56 3 39 88 17 1 2 34 83 48 52 69 75 34 74 97 86 18 55 33 83 92 59 77 47 36 24 26 34 99 83 54 60 82 1 28 46 36
20 80 71 77 27 70 25 37 26 51 39 28 13 22 89 84 72 0 14 40 94 4 10 98 56 23 35 38 30 39 84 25 41 53 2 2 17 56 79 87 92 56 46 71 59 100 45 91 54 23 16 87 63 22 74 88 82 29 91 72 39 61 11 0 94 6 97 1 56 22 67 48 87 23 8 7 28 59 85 0 61 81 49 29 73 69 15 3 86 98 28 58 81 16 39 77 27 55 30 12
49 44 47 25 100 29 72 53 60 43 38 7 86 6 73 88 39 38 2 20 88 67 93 27 92 68 100 16 61 84 44 51 64 13 12 37 44 16 54 81 17 82 87 78 39 26 69 70 68 16 51 51 83 75 72 63 69 95 58 94 93 71 78 15 95 27 56 88 74 84 20 20 70 48 42 77 52 29 79 95 34 32 90 96 62 49 14 91 82 68 22 0 77 90 85 61 56 2 60 13
32 74 84 3 93 38 31 74 97 18 67 11 68 88 72 60 28 6 99 82 10 2 30 98 70 100 48 16 23 92 53 36 34 53 77 72 64 89 16 23 60 12 20 35 1 19 15 56 23 73 74 74 100 20 32 36 39 85 24 59 51 11 48 25 26 1 71 59 14 34 86 76 60 73 79 38 34 29 5 23 4 34 28 4 14 77 80 96 32 56 68 65 64 25 99 50 84 93 53 32
41 36 10 21 98 31 76 50 15 24 85 84 16 93 83 23 36 10 83 87 58 14 37 81 80 10 50 60 90 75 31 91 17 60 55 77 54 35 7 10 59 87 54 78 32 90 16 22 44 42 31 81 62 4 76 43 69 55 88 14 27 54 79 76 99 12 27 51 29 14 61 22 60 92 6 31 45 65 65 55 29 40 7 60 2 49 74 57 32 72 35 56 16 89 89 5 23 1 90 75
40 46 67 73 81 79 53 26 67 B 16 37 70 22 18 81 0 95 75 83 33 52 17 88 32 29 87 97 45 68 16 63 49 0 6 56 4 54 51 23 0 21 0 91 17 48 42 69 64 93 7 1 10 3 89 55 88 52 79 77 74 74 19 29 94 99 18 77 45 2 2 76 39 50 16 93 33 48 48 65 81 12 96 49 51 7 66 57 61 83 10 32 86 62 45 96 24 89 30 62
88 98 83 57 3 79 37 83 82 31 45 32 9 89 55 44 51 11 39 51 91 98 54 50 29 56 37 16 7 42 24 20 38 36 68 80 88 99 13 55 23 16 32 94 26 68 38 82 55 24 36 60 33 22 16 24 6 25 47 11 74 70 54 43 27 99 20 77 87 14 16 63 23 54 5 15 43 4 22 79 76 12 58 47 30 10 38 24 28 8 2 81 68 23 1 74 32 42 7 43
35 66 19 48 37 82 23 39 82 99 43 20 44 50 95 69 3 9 60 38 38 27 14 100 59 17 95 59 55 76 3 53 31 7 8 12 77 94 51 57 52 87 13 60 51 95 47 46 21 74 25 80 7 34 39 53 92 83 6 29 50 21 100 49 58 24 62 58 70 84 42 11 79 18 56 34 60 85 25 6 56 6 10 80 43 49 32 6 37 51 3 6 54 72 31 38 7 70 9 72
6 58 13 12 41 55 37 77 39 33 90 47 58 1 59 77 100 28 84 76 4 65 29 39 10 69 83 75 77 64 13 34 73 56 97 35 54 17 61 31 52 7 49 50 76 64 75 20 41 4 96 42 35 92 86 35 76 86 67 72 96 96 59 31 33 26 41 28 17 97 70 6 83 43 95 59 7 7 28 66 89 9 1 47 86 51 54 84 2 73 22 71 81 53 62 97 90 80 25 92
69 14 50 78 92 87 38 36 19 87 61 29 40 86 21 66 71 39 63 88 11 5 24 40 78 17 95 50 58 13 86 26 3 87 42 14 97 95 45 65 62 7 7 11 69 72 2 72 70 99 78 54 16 50 52 18 45 53 97 39 97 65 94 48 64 17 57 71 72 56 14 58 82 52 95 43 12 18 65 6 21 0 63 14 44 90 72 77 54 3 66 59 83 67 3 69 58 32 90 48
58 15 17 25 23 82 22 59 96 17 82 71 93 67 54 53 54 21 31 51 28 32 90 20 1 20 96 66 20 46 48 25 80 70 27 10 7 12 94 45 48 70 50 56 2 37 2 49 20 30 4 28 84 94 72 85 90 17 59 51 96 93 12 59 13 90 56 20 95 14 60 38 39 56 73 84 43 20 59 49 16 89 70 96 23 73 87 11 70 16 19 57 50 100 83 32 12 88 50 6
30 73 19 65 60 6 80 18 40 79 45 31 93 57 87 41 60 56 65 39 79 80 27 45 18 54 96 10 60 79 32 70 71 24 81 22 45 48 22 8 83 38 17 79 81 25 90 37 65 8 45 91 24 7 47 1 55 38 27 73 79 33 4 32 20 33 54 95 90 88 29 34 27 39 61 89 56 66 5 100 51 45 85 83 46 75 17 19 69 77 12 7 72 73 71 82 79 87 9 17
77 79 29 9 6 5 63 15 55 11 87 97 21 81 67 8 95 92 24 15 2 99 73 8 19 99 21 81 78 46 6 39 21 90 64 100 96 55 8 77 9 3 51 78 48 73 45 63 83 50 57 42 11 64 75 43 57 43 75 19 58 5 79 35 93 4 34 26 3 6 99 97 65 23 72 72 57 24 52 78 50 54 54 87 54 1 86 65 65 18 33 47 9 43 68 14 63 98 91 18
31 57 83 7 90 96 46 45 65 12 17 60 51 85 24 17 70 88 32 0 84 10 18 9 75 79 70 51 21 19 44 39 16 62 43 94 96 99 11 81 100 0 100 38 35 19 23 2 64 77 83 55 51 29 58 20 52 36 33 100 7 4 17 14 34 71 78 90 89 7 25 60 99 27 26 46 12 5 68 45 23 51 73 18 59 24 3 12 87 17 42 82 44 61 72 20 96 46 48 61
88 42 67 1 16 6 56 58 24 41 6 43 18 20 92 84 28 86 41 72 34 25 7 8 83 68 85 48 4 6 15 11 78 9 98 75 75 34 60 27 71 98 54 89 38 30 95 85 36 15 28 88 82 17 84 23 39 11 31 29 69 74 64 92 48 70 65 38 7 8 81 51 12 36 3 74 37 88 62 86 64 22 7 21 25 24 9 74 85 12 67 53 8 11 32 80 17 23 58 40
49 53 64 29 10 70 4 54 28 46 39 79 95 24 61 90 93 3 63 5 9 42 47 22 50 3 20 74 34 46 40 93 99 5 82 16 30 92 29 26 86 25 83 23 26 87 71 20 21 8 1 21 5 43 78 17 4 30 40 11 8 75 15 12 28 35 25 41 54 77 98 2 69 30 70 79 17 86 84 82 28 35 71 63 18 82 0 64 20 17 86 3 7 40 88 7 36 99 43 21
16 37 63 68 11 25 74 71 66 73 9 22 12 65 25 82 86 72 12 37 95 70 66 19 29 94 99 36 54 83 66 66 33 95 57 76 50 82 61 59 85 97 56 20 2 74 11 81 46 41 34 46 51 6 94 96 60 37 56 97 2 42 60 25 94 60 56 2 14 86 93 71 94 24 27 21 76 41 75 98 31 2 34 61 13 25 33 63 49 21 4 50 86 96 8 8 82 6 57 36
85 59 79 72 62 84 1 3 41 80 10 49 62 20 96 45 29 86 22 51 16 61 30 0 8 85 9 87 22 65 81 36 2 48 69 32 25 69 30 85 43 80 15 11 69 93 61 70 97 69 8 32 79 32 74 17 11 18 72 86 54 13 25 95 58 71 89 19 1 22 20 66 50 76 43 95 66 99 33 70 61 74 47 60 60 64 84 42 87 49 79 5 84 27 77 29 96 64 92 77
52 44 38 47 69 51 31 21 76 29 16 36 61 20 64 8 81 100 8 21 29 70 9 85 3 38 47 70 89 19 86 19 2 31 50 16 9 72 97 9 72 44 95 38 71 16 27 4 74 7 43 73 66 60 84 64 59 9 11 77 2 92 8 17 52 19 34 38 83 92 99 9 63 81 70 81 19 62 91 75 40 30 84 48 40 46 79 14 16 86 56 15 81 78 78 18 76 72 17 5
27 95 71 11 65 53 36 86 74 95 60 39 91 80 63 36 97 74 51 67 67 71 64 69 5 43 1 83 27 35 77 54 15 53 7 49 4 92 32 26 26 100 22 1 7 100 50 62 45 53 93 76 59 100 96 37 10 79 99 2 52 11 45 96 88 54 28 61 3 27 49 14 76 14 34 45 45 77 57 83 39 37 46 5 34 0 95 65 10 89 17 93 3 2 55 99 11 40 70 61
19 27 53 79 34 5 92 21 90 81 5 32 93 12 65 82 76 86 35 13 53 81 98 20 91 100 0 57 32 67 70 36 91 21 47 51 43 79 39 55 87 76 97 23 37 45 60 76 26 95 90 37 6 60 66 19 20 22 26 8 52 76 28 48 40 75 63 43 94 68 51 9 93 8 69 21 16 12 22 82 9 82 40 46 30 42 24 39 96 37 10 25 46 31 67 75 44 61 93 72
28 90 38 80 82 40 66 20 44 63 14 65 19 47 6 19 22 89 100 92 80 71 75 36 74 79 95 84 5 18 85 11 23 10 29 1 59 72 77 75 33 41 28 54 86 0 52 62 38 97 74 49 0 23 38 34 3 82 13 24 99 38 91 68 63 59 93 3 15 47 54 70 90 41 41 63 25 90 68 44 88 80 3 33 5 2 87 19 17 8 23 95 68 63 45 12 67 82 4 84
20 66 22 88 40 61 52 76 30 97 18 8 100 74 89 99 58 2 32 66 81 47 83 83 55 68 27 96 6 6 59 99 61 32 70 67 69 79 22 94 57 22 4 9 74 7 41 71 26 63 29 65 82 76 2 85 79 36 36 83 0 89 92 92 65 42 6 11 4 92 69 14 34 14 34 5 85 46 49 51 4 13 14 13 70 64 6 81 10 23 86 64 26 42 53 22 37 42 14 65
7 68 29 27 71 15 15 70 97 48 65 91 70 0 93 27 8 4 84 68 96 60 40 11 88 8 49 3 65 51 12 78 34 71 45 2 89 6 66 19 0 32 70 61 43 64 55 23 64 80 82 49 68 42 88 61 2 63 78 17 92 20 98 25 9 59 97 18 60 96 27 83 7 66 77 47 80 75 62 24 63 16 26 32 90 26 4 80 74 59 98 80 47 25 25 10 68 88 49 24
61 72 69 57 42 26 78 27 53 99 5 73 51 4 68 21 74 49 35 22 74 94 25 6 56 39 20 4 20 9 95 10 65 54 41 21 83 73 95 7 32 26 96 29 71 4 95 34 88 34 48 44 38 88 59 58 0 25 72 10 28 98 64 71 1 68 70 17 86 14 78 25 81 47 53 50 48 25 21 48 87 14 8 36 97 96 60 19 99 83 31 79 24 32 46 4 19 3 37 82
57 13 2 81 43 67 29 46 31 7 95 40 23 27 72 91 29 78 86 89 43 52 47 94 53 34 11 97 55 46 7 75 89 86 97 46 6 15 72 32 17 35 54 27 25 50 98 49 27 4 2 10 35 30 26 11 78 45 36 43 9 11 29 34 80 54 8 17 56 61 92 98 6 12 11 76 41 61 30 84 91 42 97 65 51 81 73 87 74 51 70 56 24 41 42 44 65 17 39 49
86 34 76 10 5 90 45 73 90 53 13 71 38 78 66 46 36 97 78 69 91 0 91 23 67 89 89 97 40 1 19 55 12 56 81 81 7 97 3 24 46 34 31 19 31 64 69 67 93 23 57 61 24 38 53 49 62 83 24 2 45 48 54 10 80 14 51 68 69 97 87 5 53 52 92 66 75 33 97 26 3 68 79 45 66 1 86 13 84 5 50 57 89 75 73 11 57 48 63 76
46 58 2 15 75 6 32 79 81 82 62 33 55 48 82 3 100 84 54 40 79 87 91 95 88 66 72 39 52 78 76 86 59 16 36 70 95 28 60 4 12 93 0 67 32 49 85 93 58 75 0 17 52 42 34 16 10 60 4 94 50 67 64 97 48 69 95 17 62 0 9 83 52 11 75 42 27 75 66 74 47 37 11 55 80 87 50 64 70 16 0 8 66 17 67 34 28 67 5 17
31 82 17 80 77 38 60 58 17 6 14 100 22 22 45 50 49 100 85 42 10 95 87 40 12 49 44 41 89 89 14 34 72 45 16 50 82 47 73 4 46 78 23 33 85 16 92 24 90 8 71 70 6 82 4 10 69 47 54 15 95 70 48 37 74 100 12 97 100 30 17 80 44 95 85 74 85 9 56 52 90 40 3 50 31 3 56 27 9 78 46 38 89 50 38 43 3 13 52 60
51 89 49 55 51 1 51 63 23 56 78 93 60 0 78 25 83 100 11 80 100 72 64 8 5 100 69 16 49 70 81 84 6 37 49 35 40 11 84 21 1 12 69 23 4 50 69 2 92 52 92 20 79 30 72 28 94 4 43 71 61 15 34 76 71 87 45 14 33 12 86 16 14 54 8 32 72 64 8 61 96 65 41 87 35 31 31 56 97 61 69 4 19 60 86 62 37 32 24 100
84 27 5 90 95 43 87 16 52 87 53 25 88 28 33 54 22 29 21 94 51 57 5 94 51 83 81 74 19 34 27 3 19 33 33 69 33 89 45 39 90 37 8 3 50 13 78 87 47 22 58 38 81 20 24 73 0 18 59 57 99 77 1 66 32 43 55 92 63 67 97 61 42 10 31 94 2 90 2 14 5 58 27 9 52 28 43 77 24 24 81 39 35 78 54 75 21 76 91 2
71 43 66 45 1 68 50 31 17 9 82 41 65 63 41 15 43 88 68 32 64 56 84 5 69 15 73 80 57 68 62 73 60 39 79 3 16 80 65 40 37 10 6 7 71 51 19 62 83 98 97 66 6 12 32 67 35 70 40 65 22 99 97 40 43 58 81 98 32 29 13 27 31 39 20 2 9 71 80 55 97 27 0 17 18 12 34 37 29 10 43 15 26 93 63 39 72 57 72 18
41 42 33 60 64 76 9 5 36 48 37 22 14 88 8 48 65 85 15 34 29 84 56 89 92 2 80 58 21 30 12 90 50 21 20 19 45 70 70 61 90 49 13 42 85 66 16 78 63 10 79 49 48 38 24 68 62 50 43 56 4 47 48 100 64 71 56 60 21 11 28 66 54 6 80 59 71 23 98 69 49 0 43 44 37 54 41 59 88 7 1 29 36 16 7 65 56 74 90 16
31 55 24 80 69 28 1 23 94 79 67 40 99 48 57 84 82 60 59 91 66 45 22 16 76 76 68 48 86 18 47 44 84 53 34 12 47 63 41 96 69 63 2 32 14 90 100 28 5 15 14 31 100 65 29 1 54 24 78 87 22 53 14 55 94 31 90 18 5 2 38 37 97 65 89 65 78 17 100 2 14 60 12 99 1 9 51 92 35 86 19 86 99 51 72 28 100 21 25 1
12 15 19 9 75 29 86 90 54 7 100 1 87 46 8 34 96 29 11 12 82 99 80 60 35 31 75 15 30 59 22 61 3 44 35 99 7 11 98 79 65 47 0 18 6 55 79 10 86 6 25 3 80 60 89 79 50 43 40 95 84 77 25 22 100 68 54 5 63 69 57 19 4 64 77 66 63 76 50 59 90 19 42 36 68 8 5 7 26 89 34 60 71 10 68 58 52 9 25 52
40 19 78 62 52 30 43 43 57 73 48 20 81 25 37 7 86 3 38 9 72 81 95 5 53 86 71 71 B 69 68 74 62 77 7 18 31 46 32 26 62 9 76 45 10 80 57 75 59 7 87 42 86 97 28 87 4 46 47 25 54 60 11 71 20 18 75 41 49 2 82 60 38 27 75 45 1 10 31 68 52 51 63 69 40 0 51 52 77 49 87 7 86 7 98 44 45 3 84 93
39 25 41 13 38 55 83 6 73 75 45 83 17 98 22 22 46 19 45 89 93 17 11 73 6 67 64 0 61 16 6 77 68 90 48 37 40 53 43 75 32 39 78 25 69 52 82 51 35 88 73 4 2 48 65 94 61 63 34 27 2 51 12 79 90 64 33 99 81 1 12 20 83 1 33 74 54 96 1 38 20 17 19 53 89 49 5 71 61 91 83 91 86 53 3 69 1 97 2 98
97 23 70 23 99 18 61 7 74 97 70 7 63 15 26 62 57 21 89 11 97 14 21 91 2 64 96 86 17 41 92 42 3 75 64 12 68 98 34 0 80 17 33 60 38 11 95 82 53 39 81 57 29 21 72 13 67 97 22 27 86 72 76 13 47 55 61 52 51 97 32 93 17 57 95 40 93 33 14 41 81 48 73 61 8 22 34 15 20 91 38 60 9 24 17 84 77 62 5 24
26 71 1 29 76 64 25 14 10 66 81 34 71 31 22 16 74 97 89 53 81 43 15 70 8 8 71 87 89 32 16 73 30 74 37 72 64 12 64 46 30 34 57 79 40 47 55 10 28 88 28 84 47 64 60 46 68 89 86 55 82 7 18 33 92 33 18 42 6 46 95 85 55 18 35 67 98 34 55 68 37 82 6 57 10 80 97 57 79 37 93 57 41 34 4 66 61 2 10 57
4 3 96 34 19 40 67 14 63 23 5 43 40 47 40 67 19 53 10 59 8 15 91 7 16 29 91 56 7 52 61 30 71 23 17 87 98 40 81 28 65 70 20 8 27 74 81 56 53 94 49 19 40 67 56 99 86 43 95 83 11 25 79 57 68 76 9 84 0 70 85 2 0 84 70 76 32 5 57 29 1 2 69 84 28 6 87 88 87 7 80 42 25 8 65 33 93 87 73 79
29 45 63 96 79 58 31 67 16 99 52 18 60 61 89 54 1 85 13 12 45 29 6 54 61 22 42 52 58 47 31 34 25 14 57 76 60 92 82 26 51 92 45 7 26 20 64 56 64 46 77 93 63 95 11 26 1 14 100 33 25 1 66 67 99 67 55 86 75 33 43 54 36 93 42 21 42 70 42 11 64 13 55 94 32 73 66 7 21 42 66 62 62 25 56 6 16 90 6 42
73 75 20 29 60 34 44 85 35 64 82 54 32 24 37 87 35 35 83 23 64 93 85 22 37 72 33 100 93 72 19 41 6 14 22 58 77 42 53 62 73 15 88 57 47 95 58 77 70 54 9 86 44 10 11 92 94 20 64 41 60 1 71 75 21 70 51 11 55 22 68 24 100 71 46 39 34 34 33 93 12 53 24 45 55 94 96 19 65 27 53 12 22 18 80 78 70 58 31 59
15 80 11 92 37 39 89 78 88 78 24 37 91 59 33 95 17 48 56 48 96 80 27 87 15 44 49 80 82 31 14 100 36 71 7 2 48 90 95 52 47 5 87 43 13 88 85 46 75 37 52 87 14 11 100 98 80 40 10 60 18 9 1 8 76 56 78 62 31 91 88 61 43 29 68 73 18 32 63 27 20 46 47 85 28 56 28 9 21 49 56 12 99 33 7 96 45 25 45 74
71 57 63 67 27 64 59 66 9 57 3 29 51 77 56 89 22 64 58 89 90 82 18 64 16 60 89 31 61 75 62 64 14 47 38 42 72 71 50 27 13 55 35 27 8 44 58 78 2 29 10 30 1 91 45 96 87 14 42 93 89 70 0 67 56 13 60 91 2 24 67 87 37 89 90 26 74 68 13 29 12 60 21 28 0 49 2 0 50 69 76 24 11 20 93 75 7 62 73 94
91 12 76 89 76 30 65 60 21 67 93 86 65 49 37 99 46 15 92 8 47 78 14 57 33 77 6 64 13 51 93 90 4 58 65 32 19 86 76 56 74 9 67 25 49 19 61 7 27 65 11 58 85 53 64 54 78 37 20 79 6 56 5 14 88 81 31 6 27 35 27 32 11 39 8 71 30 57 49 78 96 100 63 21 46 26 4 79 10 13 40 98 83 96 13 20 95 67 94 19
70 3 41 32 55 44 29 20 85 98 14 80 31 37 90 4 41 67 17 31 11 57 69 49 25 16 43 32 49 74 84 59 89 42 80 53 50 41 37 43 32 37 30 71 50 53 55 41 59 42 4 52 34 29 64 25 43 3 44 32 77 74 69 84 79 64 96 24 16 23 97 25 35 24 50 33 4 25 48 76 80 67 7 92 77 65 38 30 9 32 57 26 32 40 42 46 21 47 34 53
24 27 32 22 43 68 53 87 39 8 93 37 50 63 1 50 62 58 55 66 90 79 1 50 98 87 18 28 14 4 74 81 38 76 69 22 54 92 79 22 12 82 22 74 70 43 19 50 72 95 71 16 6 50 84 90 15 87 14 39 61 66 93 75 85 74 90 87 80 61 93 57 83 20 33 36 60 46 54 10 68 73 44 47 13 15 92 20 32 12 53 13 26 1 52 48 97 76 94 57
86 74 17 25 71 61 36 75 49 39 69 79 84 16 40 8 76 23 4 92 22 95 37 61 12 18 99 49 0 70 74 33 69 47 99 67 73 4 2 24 23 6 33 15 78 41 59 28 27 46 7 47 73 97 92 78 23 80 71 35 27 32 8 46 91 46 52 54 92 5 70 16 3 50 13 1 43 29 73 96 83 42 35 45 3 79 1 38 42 44 9 62 76 43 96 49 60 77 90 86
72 9 71 100 84 55 83 76 89 77 47 97 10 41 74 4 96 10 49 96 32 18 74 43 28 0 28 56 86 69 1 30 72 3 85 21 67 44 6 4 31 34 36 71 47 86 47 48 7 54 71 35 10 15 2 63 18 20 61 89 78 56 11 39 64 1 45 44 76 27 57 34 86 92 3 77 73 53 97 25 29 84 75 100 61 25 94 46 21 61 93 32 68 25 79 15 83 82 51 4
23 91 74 37 68 39 4 44 32 25 94 65 42 14 57 40 73 11 72 35 100 7 75 14 30 47 14 74 41 33 86 26 86 42 33 65 52 70 97 98 58 92 43 95 25 13 26 36 20 94 55 94 57 6 84 66 3 58 10 33 82 31 76 63 58 77 71 86 39 80 97 73 6 72 3 53 82 87 93 5 2 89 23 82 60 100 32 33 18 81 36 57 2 77 24 16 56 7 72 23
34 90 85 36 10 28 94 62 92 9 2 76 86 3 100 74 65 57 6 21 16 17 35 95 96 11 99 34 16 64 16 78 95 17 82 7 22 21 54 37 70 17 39 8 78 73 32 12 75 5 10 9 21 24 41 59 76 13 7 68 73 17 10 62 77 9 52 21 40 18 48 98 32 79 24 28 93 39 82 21 91 82 23 19 5 60 76 23 59 84 53 51 100 89 95 78 29 59 59 78
67 6 58 74 18 72 40 5 0 30 92 37 95 76 6 18 42 26 37 16 7 86 71 73 9 61 22 99 20 48 77 16 18 0 8 70 79 99 86 80 80 50 91 95 64 51 19 16 41 85 7 52 69 18 13 98 15 78 58 95 3 41 16 99 39 82 30 84 76 25 25 58 88 7 39 45 82 27 15 83 65 46 13 9 53 79 13 74 85 46 45 65 75 50 41 17 94 97 13 60
33 98 96 67 57 44 46 79 46 59 56 61 59 41 18 29 65 84 5 80 25 30 50 86 67 53 93 39 71 6 32 96 59 48 18 61 82 65 85 59 56 79 99 8 48 29 36 75 77 23 28 82 20 51 97 86 39 22 79 46 69 67 34 99 91 30 22 36 49 47 10 79 82 93 23 98 61 27 83 0 84 48 49 55 41 5 18 85 47 83 89 24 90 37 56 22 80 97 76 79
87 17 38 48 65 44 69 74 88 91 67 69 34 32 35 75 6 87 59 15 4 55 54 22 39 78 43 16 44 100 15 41 69 67 30 60 50 56 28 17 0 73 10 2 51 91 53 45 1 35 89 73 15 10 9 70 57 71 79 4 17 77 2 86 54 91 59 28 33 51 76 49 82 71 5 31 83 72 75 44 29 56 88 27 71 35 85 43 43 65 97 43 63 56 60 26 37 59 92 12
48 49 86 84 75 7 38 77 58 82 29 91 72 38 71 63 7 83 79 11 82 B 72 20 79 99 31 14 61 67 45 23 54 7 23 51 40 17 87 20 43 0 58 39 83 62 52 13 54 100 84 56 92 37 93 26 75 77 49 25 62 82 68 14 47 18 30 48 3 83 78 5 67 13 69 52 97 63 92 19 15 78 36 24 63 49 6 91 14 60 69 48 36 37 94 24 64 54 12 72
55 64 51 62 8 69 64 85 38 21 52 65 96 68 72 72 37 79 5 86 48 66 65 87 13 88 11 86 95 41 61 91 60 44 30 60 15 46 56 55 93 98 99 70 58 14 63 58 69 15 83 31 44 94 77 25 13 47 54 93 11 78 50 13 13 95 23 39 100 85 59 92 21 57 24 42 16 2 52 91 46 11 35 49 28 17 15 43 6 18 12 96 15 51 99 66 68 42 10 95
49 40 28 50 21 50 86 1 38 0 6 8 32 17 18 18 69 11 95 0 60 29 100 94 75 23 88 96 14 36 29 8 7 98 43 30 42 33 31 79 57 15 37 5 22 85 14 26 29 97 10 42 3 95 8 94 22 36 28 20 22 84 4 17 35 18 26 24 89 15 38 39 100 23 9 65 27 84 91 93 80 17 63 27 26 52 6 47 100 48 52 20 1 69 33 82 46 5 S 76
65 63 27 49 56 6 53 62 22 62 72 77 50 73 0 17 41 31 75 22 21 82 55 44 23 36 42 32 11 65 4 73 58 54 43 39 84 46 47 99 84 6 33 57 55 29 17 10 33 77 66 90 80 10 88 88 100 87 83 49 18 5 30 60 42 94 99 42 27 72 88 11 95 27 41 32 26 96 85 82 10 95 84 58 51 20 40 23 87 11 19 26 91 84 90 92 98 95 15 42
31 91 95 42 40 57 10 39 72 3 77 27 32 93 2 65 28 90 21 15 9 34 66 30 97 99 4 59 45 23 62 50 39 44 21 70 22 4 0 2 69 42 61 92 100 62 82 5 31 68 24 99 60 44 98 23 93 45 20 66 37 52 44 22 8 40 37 37 66 88 49 97 56 74 20 19 33 69 41 30 38 21 12 92 51 41 31 81 91 50 95 65 56 61 84 57 63 31 58 91
67 55 94 48 53 34 88 14 87 13 9 28 66 94 75 56 36 64 99 35 12 11 68 47 52 86 49 36 50 52 27 21 29 32 65 57 64 58 88 12 68 65 71 20 89 13 92 94 92 38 15 16 85 76 5 89 81 94 70 85 73 98 48 6 100 47 38 93 25 9 94 12 40 57 16 83 62 87 68 39 85 97 31 97 70 5 97 27 20 78 71 79 0 90 25 23 69 94 83 30
23 60 52 79 58 70 23 32 18 74 17 99 58 4 51 54 46 65 70 79 19 94 74 90 83 30 90 52 95 32 63 74 74 21 77 56 10 33 12 86 19 30 66 58 50 35 82 14 70 48 65 91 92 2 23 51 92 17 0 42 100 46 20 83 61 80 51 65 36 75 25 99 56 96 34 77 61 53 15 23 93 8 93 89 74 31 49 67 13 27 68 85 9 78 66 88 17 81 65 32
80 31 84 78 32 64 34 62 82 0 67 27 4 7 32 88 43 88 15 21 94 60 38 63 98 73 8 90 58 99 85 66 14 4 18 79 33 2 89 32 98 68 96 5 53 44 55 12 35 37 80 75 30 43 50 20 50 96 21 22 17 96 52 0 41 75 44 41 44 60 69 34 27 32 57 58 32 75 75 84 24 24 24 17 40 62 29 96 19 39 19 25 46 35 35 51 39 69 52 25
91 67 50 99 76 50 93 53 43 59 24 9 32 60 94 20 4 47 90 18 36 65 60 46 29 14 95 32 36 60 58 69 85 72 14 45 6 79 27 74 19 13 18 0 52 33 4 75 70 29 58 13 24 86 31 24 14 93 56 79 64 73 62 72 72 90 11 35 9 89 82 74 62 85 38 57 6 35 98 86 88 89 83 43 13 21 30 71 61 38 85 93 20 62 43 43 17 45 56 49
13 25 38 82 18 21 16 26 73 22 97 8 47 72 45 32 54 72 67 39 20 0 82 82 6 40 65 58 3 82 92 52 27 74 98 84 33 58 12 74 67 8 99 59 33 28 17 20 68 70 48 4 27 27 14 23 62 37 60 64 93 72 2 64 27 51 77 8 83 31 42 52 49 4 4 76 30 24 20 26 38 20 97 94 40 99 35 33 19 65 94 86 24 17 87 31 79 31 72 35
38 49 28 93 32 99 63 100 68 28 78 64 49 68 10 25 58 92 33 45 89 73 57 62 49 68 89 12 40 11 7 9 67 31 91 31 49 47 0 90 41 87 63 48 87 58 52 18 96 95 40 52 35 72 85 9 96 83 43 46 56 21 63 77 91 77 32 69 60 7 36 23 52 32 25 71 86 42 29 98 85 36 26 89 81 3 92 87 63 38 62 19 57 99 96 9 98 55 97 43
3 58 44 36 84 82 83 10 99 31 16 47 2 2 65 91 82 84 31 68 32 57 58 19 36 23 42 88 57 17 59 45 5 3 36 40 26 94 6 1 42 70 19 33 20 69 61 21 19 65 78 93 83 61 9 2 24 64 98 25 76 100 46 42 7 31 61 81 41 41 55 37 94 7 12 34 50 30 71 78 16 96 92 49 71 81 4 28 91 71 13 38 0 35 96 13 49 68 81 93
92 26 31 23 62 95 41 23 96 77 93 84 92 43 98 43 14 51 14 67 28 57 41 51 85 8 20 88 38 40 99 22 8 71 97 85 44 91 26 96 99 70 93 60 2 18 12 31 13 7 14 21 82 67 14 78 78 65 38 49 73 84 91 18 13 31 75 89 85 28 98 88 96 97 90 8 26 5 4 51 50 7 0 35 78 64 95 77 31 43 84 0 70 7 91 57 37 14 34 35
48 17 69 63 59 74 17 21 45 100 51 94 22 76 91 67 54 11 20 70 81 38 94 75 39 49 26 83 35 32 16 9 36 74 97 57 91 1 5 65 81 8 90 94 37 12 57 51 77 91 61 24 28 72 78 6 16 78 20 27 96 65 60 9 83 8 46 50 69 12 71 28 88 18 57 81 15 89 8 0 37 100 19 32 15 87 90 83 65 45 84 59 73 97 53 19 60 32 87 93
31 64 20 13 30 76 82 13 89 2 80 90 38 51 47 37 78 98 32 11 29 31 32 49 11 3 97 14 44 46 56 39 85 26 98 82 29 11 24 4 11 1 21 42 67 61 94 75 35 19 87 82 66 66 29 71 33 65 19 70 33 33 27 40 99 82 98 0 25 49 16 51 13 49 31 87 78 24 45 34 75 92 64 82 42 27 68 55 87 93 55 88 34 41 41 55 76 84 28 3
80 14 66 47 74 72 95 67 39 4 0 90 11 47 59 53 10 40 27 75 17 7 39 28 4 62 92 70 18 69 69 30 32 11 78 7 35 71 81 90 14 58 87 95 6 32 9 74 7 79 16 25 15 1 69 100 89 74 43 94 60 71 92 12 98 35 61 84 55 76 15 36 99 23 48 56 29 77 46 73 38 46 63 14 100 80 64 87 67 99 61 90 100 80 98 68 77 67 47 61
94 2 93 45 17 90 93 79 96 89 47 10 32 10 42 46 22 0 69 61 49 78 88 6 22 98 59 44 61 57 91 39 53 46 61 66 0 43 69 47 87 88 50 89 71 18 37 52 62 93 11 4 5 30 62 12 52 67 95 29 81 34 92 1 E 75 74 87 18 88 30 15 43 33 81 63 88 92 26 32 29 11 100 60 18 26 24 58 11 5 13 24 85 4 2 45 76 92 88 43
60 7 93 53 34 84 20 93 10 5 71 16 15 66 26 77 77 70 25 88 46 70 11 14 18 28 57 19 17 1 96 68 28 16 55 72 82 100 20 86 95 52 94 10 23 40 90 5 63 32 50 28 22 46 83 26 84 8 5 69 84 94 89 16 72 6 66 84 77 27 84 2 75 21 46 30 27 91 27 85 35 95 45 93 34 39 90 73 1 61 31 10 2 49 19 17 49 23 100 66
10 4 1 15 63 44 48 53 47 4 33 34 7 31 60 43 73 82 98 37 67 31 88 26 92 46 6 2 63 95 26 50 97 50 54 5 10 59 22 9 34 31 24 90 15 27 81 84 11 23 71 72 55 42 43 28 82 84 7 92 10 98 93 12 62 57 49 87 3 47 50 40 39 14 66 15 15 3 32 1 18 75 63 16 58 99 87 54 88 9 67 84 30 71 73 65 92 60 53 13
88 87 26 54 1 11 7 85 27 68 84 4 9 24 73 75 11 33 41 42 23 50 45 11 18 20 6 61 54 30 98 19 6 44 97 40 51 50 37 66 14 48 47 80 95 65 83 40 39 43 54 8 82 52 16 13 35 91 72 83 61 42 57 16 4 24 10 75 96 19 21 78 86 70 73 68 54 5 58 93 88 24 34 91 38 41 75 42 76 66 6 32 36 5 29 26 59 3 48 38
79 74 69 34 30 15 94 4 57 30 10 18 55 73 92 100 93 0 12 89 87 78 38 67 85 99 51 84 27 54 41 18 82 39 14 85 58 81 82 56 41 42 80 100 86 25 24 64 1 33 38 54 40 58 49 89 34 55 98 80 98 71 58 54 63 57 37 2 75 29 62 43 20 44 10 24 87 59 97 69 26 46 20 B 7 2 24 34 75 18 27 6 37 44 61 79 26 88 82 0
22 95 34 51 79 27 34 9 12 58 49 54 89 65 85 96 50 64 74 100 29 47 7 26 89 72 91 20 89 67 27 28 25 15 73 76 25 88 24 57 48 43 89 10 77 18 24 48 92 49 55 48 50 60 78 3 85 62 18 76 78 8 3 16 97 72 45 10 86 18 12 68 62 26 40 42 9 79 12 48 43 51 63 54 9 58 2 71 62 27 76 88 6 4 45 78 9 35 28 41
75 55 33 81 6 75 3 99 58 76 55 27 61 79 20 44 95 84 25 98 6 27 98 93 5 83 35 28 37 3 7 73 92 27 35 90 11 53 54 36 53 78 40 59 28 45 33 13 77 75 33 64 54 80 22 98 88 23 38 78 31 79 93 14 100 68 50 61 50 75 54 41 53 76 1 24 35 33 19 66 47 17 8 24 17 88 40 11 43 51 10 20 55 40 39 51 0 10 21 36
80 91 13 91 82 72 79 20 24 90 18 40 30 64 42 77 72 60 46 51 40 27 27 39 61 58 94 65 93 81 35 62 50 38 71 12 78 15 36 96 61 1 11 71 67 90 63 50 32 87 50 57 76 5 55 15 88 72 63 26 100 17 97 39 57 56 91 30 7 10 83 71 27 80 96 68 69 24 40 77 45 94 16 66 67 78 13 43 41 63 25 26 52 76 81 32 86 6 7 26
7 94 82 45 30 7 87 29 41 69 1 9 69 93 99 23 75 14 13 63 61 42 42 49 61 10 83 74 26 48 80 2 86 24 9 4 70 81 32 24 1 30 68 65 79 28 100 84 52 11 85 17 53 65 51 10 85 88 24 77 21 85 40 82 18 30 36 26 97 41 19 58 56 9 89 25 84 31 69 23 79 9 76 82 7 9 38 0 99 84 49 27 51 100 34 94 71 44 6 35
90 8 7 24 56 61 40 37 92 98 49 40 95 38 4 38 52 96 64 78 55 93 20 96 87 75 20 61 40 32 88 11 97 83 56 98 32 49 45 72 32 42 43 12 76 21 57 41 50 44 50 80 25 14 44 24 39 92 46 14 95 67 51 55 77 93 37 65 38 10 91 44 66 29 35 80 12 45 40 73 64 19 71 78 1 94 12 11 19 32 32 31 85 91 100 71 76 35 95 91
48 23 14 85 93 83 74 74 46 9 95 21 71 82 24 31 29 82 99 69 77 41 60 88 84 82 80 69 39 12 59 79 21 74 20 90 92 12 77 21 46 44 48 81 65 79 50 39 79 43 23 19 95 30 19 86 61 3 98 69 82 61 8 57 21 99 82 32 64 95 37 39 9 55 17 7 10 44 27 65 45 15 83 26 93 85 51 13 95 8 60 42 64 91 37 59 23 78 50 99
70 92 96 80 23 95 13 20 47 57 85 97 25 49 55 48 64 53 40 38 20 52 82 30 53 48 52 73 68 2 94 65 70 25 96 9 90 6 26 47 44 58 13 84 77 54 38 88 23 27 40 75 28 53 67 89 85 51 47 76 14 81 2 0 15 4 75 39 97 87 26 79 89 49 12 85 2 69 58 92 82 31 77 42 89 54 18 16 35 96 69 0 2 53 6 52 50 38 21 33
2 16 22 96 18 3 53 90 13 0 54 71 24 67 70 50 48 32 66 25 34 23 9 1 32 63 94 67 12 85 10 83 15 88 46 31 54 63 35 78 19 24 86 60 73 51 33 33 9 23 100 35 78 90 84 50 74 31 34 47 34 26 50 42 17 26 32 74 63 15 69 20 81 53 58 4 30 37 69 47 99 7 43 1 40 22 43 88 51 72 37 0 62 40 46 64 50 10 19 48
78 73 82 11 93 63 80 85 88 61 96 28 65 30 81 20 58 22 93 37 92 79 70 40 0 14 8 52 67 59 81 83 23 71 13 52 30 11 65 96 20 18 30 80 94 29 95 31 48 1 38 8 16 90 9 31 96 89 66 11 32 59 3 7 6 82 79 2 72 56 90 88 69 67 3 55 95 4 41 3 52 16 86 8 69 30 37 47 29 2 0 11 11 94 69 10 38 40 12 78
79 20 57 78 87 12 82 68 97 89 99 60 35 53 71 20 9 6 46 89 41 41 23 90 64 48 60 80 26 72 27 98 41 84 45 36 64 79 52 93 22 67 25 33 36 77 89 39 65 77 C 28 1 67 23 21 20 44 68 77 20 67 96 80 24 93 70 29 45 35 4 51 18 8 11 63 36 84 39 7 45 99 20 2 13 15 76 49 57 98 53 8 65 5 69 28 69 77 91 28
15 85 61 19 94 90 20 85 85 63 43 84 64 46 86 92 48 58 10 63 49 14 31 94 54 78 97 93 20 40 15 88 55 15 58 100 64 64 2 10 100 35 69 11 67 62 7 55 89 42 52 9 67 46 98 33 22 80 19 89 99 92 28 88 52 1 71 97 27 30 74 60 68 32 61 66 4 98 32 79 32 38 85 78 7 100 66 16 75 17 27 2 77 82 7 21 28 30 56 64
75 31 29 46 50 63 72 87 29 33 48 7 45 67 95 70 52 59 65 9 12 91 79 28 46 97 23 98 65 99 65 79 18 89 59 86 44 11 7 9 5 79 96 31 58 32 95 68 54 96 69 92 46 32 93 87 68 30 4 63 47 62 61 23 76 40 4 95 14 79 68 74 52 47 30 18 28 0 25 5 6 46 21 72 84 100 47 33 86 97 3 31 17 86 78 38 32 88 1 32
27 54 24 14 70 71 92 41 5 99 57 81 83 81 93 41 63 96 83 23 14 22 29 7 97 68 94 34 17 92 64 33 98 11 9 54 9 80 73 76 15 71 47 38 61 34 4 92 39 2 79 63 87 49 62 63 60 90 38 64 93 76 93 28 37 92 61 18 24 78 36 13 16 69 52 55 59 39 30 66 12 7 86 47 61 97 55 85 71 71 46 85 12 46 87 3 49 22 0 18
26 32 2 58 24 99 51 59 50 4 0 44 18 98 98 50 33 29 4 96 34 59 42 48 77 0 29 54 50 36 71 35 25 97 4 8 79 5 16 40 36 67 24 65 95 50 74 16 97 62 81 66 81 1 54 62 41 5 10 49 34 4 40 26 90 95 76 17 54 30 59 36 7 86 74 80 74 79 65 45 10 42 24 73 63 6 18 41 48 62 73 82 14 91 95 0 46 12 83 13
16 20 26 82 62 57 30 74 96 27 26 98 35 5 57 15 96 85 88 39 52 95 19 19 39 26 7 52 35 16 98 79 86 54 35 1 31 96 66 73 100 47 46 62 B 89 31 58 17 64 80 62 9 100 34 77 19 90 81 50 95 94 20 56 31 87 23 55 96 52 50 61 74 12 88 54 83 43 94 34 59 76 24 41 72 22 87 36 62 84 79 57 56 6 75 66 21 70 26 84
33 21 15 79 11 93 88 62 96 89 72 91 92 5 80 77 13 7 91 96 82 70 60 63 24 44 56 3 73 13 77 81 38 19 75 88 80 55 80 78 77 92 30 86 44 99 95 27 100 84 100 88 14 22 9 58 14 50 59 58 24 54 86 19 32 16 67 77 7 6 62 39 24 18 27 58 60 84 46 15 30 34 60 41 47 80 0 40 49 32 6 46 25 66 59 86 26 30 23 93
18 27 43 43 28 35 41 15 6 38 24 75 88 25 82 5 35 22 54 0 51 94 45 17 31 40 63 30 14 34 85 90 73 61 85 58 19 61 89 48 68 74 92 95 15 28 96 80 46 4 48 82 85 74 64 97 82 84 42 67 38 39 15 30 85 34 3 95 71 49 99 34 26 38 67 43 86 30 43 30 91 24 9 18 63 24 35 43 64 19 77 0 28 46 61 28 21 87 29 77
40 64 24 2 11 58 20 25 41 77 31 74 86 52 38 44 53 90 26 26 6 45 83 82 14 29 67 74 95 70 85 93 68 18 3 92 43 100 91 77 18 12 79 82 88 68 13 73 97 54 68 97 81 37 19 26 8 2 4 93 66 73 34 80 48 39 45 56 6 13 46 16 70 41 70 81 57 33 16 56 11 95 32 19 19 57 75 92 61 5 22 87 48 94 80 38 77 42 4 18
7 74 3 10 93 63 7 14 6 24 59 73 83 47 62 37 39 5 51 87 59 69 68 32 43 80 30 83 12 48 78 3 27 80 92 5 91 67 71 61 28 90 94 75 60 19 19 74 42 59 40 66 69 70 75 86 53 52 7 86 30 45 77 44 38 76 10 22 4 9 19 21 58 81 28 68 42 41 57 26 62 91 20 31 36 10 51 77 72 55 88 74 50 19 45 84 16 10 88 95
